{
    "background_color": "LightBlue",
    "font_color": "Black",
    "stars": 10,
    "start_position": {
        "x": 8,
        "y": 144
    },
    "monsters": [
        {
            "position": {
                "x": 136,
                "y": 144
            },
            "sprite": 13,
            "movement": 1
        }
    ],
    "tiles": [1, 1, 1, 1, 1, 1, 1, 1, 1, 1, 1, 1, 1, 1, 1, 1, 1, 1, 1, 1, 1, 1, 1, 1, 1, 1, 1, 1, 1, 1,
            1, 1, 1, 1, 1, 1, 1, 1, 1, 1, 1, 1, 1, 1, 1, 1, 1, 1, 1, 1, 1, 1, 1, 1, 1, 1, 1, 1, 1, 1,
            1, 1, 1, 1, 1, 1, 1, 1, 1, 1, 1, 1, 1, 1, 1, 1, 1, 1, 1, 1, 1, 1, 1, 1, 1, 1, 1, 1, 1, 1,
            1, 1, 11, 0, 1, 1, 1, 1, 1, 1, 1, 1, 0, 11, 1, 1, 1, 1, 1, 1, 1, 11, 1, 1, 11, 1, 1, 1, 1, 1,
            1, 1, 0, 11, 1, 1, 1, 1, 1, 1, 1, 1, 11, 1, 1, 1, 1, 1, 1, 11, 1, 1, 1, 1, 1, 1, 11, 1, 1, 1,
            1, 1, 0, 0, 1, 1, 1, 1, 1, 1, 1, 1, 0, 0, 1, 1, 1, 1, 1, 0, 32, 0, 1, 1, 0, 1, 0, 31, 1, 1,
            1, 5, 4, 4, 6, 1, 1, 1, 1, 1, 1, 5, 4, 4, 6, 1, 1, 1, 5, 4, 4, 4, 6, 10, 5, 4, 4, 6, 1, 1,
            1, 1, 1, 1, 1, 1, 1, 1, 1, 1, 1, 1, 1, 1, 1, 1, 1, 1, 1, 1, 1, 1, 1, 10, 1, 1, 1, 1, 1, 1,
            1, 1, 1, 1, 1, 1, 1, 1, 1, 1, 1, 1, 1, 1, 1, 1, 1, 1, 1, 1, 1, 1, 1, 10, 1, 1, 1, 1, 1, 1,
            1, 1, 1, 1, 1, 1, 1, 1, 1, 1, 1, 1, 1, 1, 1, 1, 1, 1, 1, 1, 1, 1, 1, 10, 1, 1, 11, 1, 1, 1,
            1, 1, 1, 1, 31, 1, 13, 1, 32, 1, 1, 1, 1, 1, 1, 1, 1, 1, 1, 1, 1, 1, 1, 10, 1, 1, 1, 1, 1, 1,
            1, 1, 1, 1, 5, 4, 4, 4, 6, 1, 1, 1, 1, 1, 1, 1, 1, 1, 1, 1, 1, 1, 1, 10, 31, 1, 0, 1, 32, 1,
            1, 1, 1, 1, 1, 1, 1, 1, 1, 1, 1, 1, 1, 1, 1, 1, 1, 1, 1, 1, 1, 1, 1, 10, 5, 4, 4, 4, 6, 1,
            1, 1, 1, 1, 1, 1, 1, 1, 1, 1, 1, 1, 1, 1, 1, 1, 1, 1, 1, 1, 1, 1, 1, 10, 1, 1, 1, 1, 1, 1,
            1, 1, 1, 1, 1, 1, 1, 1, 1, 1, 1, 1, 1, 1, 1, 1, 1, 1, 1, 1, 1, 1, 1, 10, 1, 1, 1, 1, 1, 1,
            1, 1, 1, 1, 1, 11, 1, 11, 1, 1, 1, 1, 1, 1, 1, 1, 1, 1, 1, 1, 1, 1, 1, 10, 1, 1, 1, 1, 1, 1,
            1, 1, 1, 1, 1, 1, 1, 1, 1, 1, 1, 1, 1, 1, 1, 1, 1, 1, 1, 1, 1, 1, 1, 10, 1, 1, 1, 1, 1, 1,
            1, 1, 1, 1, 1, 0, 31, 0, 0, 1, 1, 1, 1, 1, 1, 1, 1, 1, 1, 1, 1, 1, 1, 10, 1, 1, 1, 1, 1, 1,
            1, 1, 32, 1, 5, 4, 4, 4, 6, 1, 0, 36, 0, 31, 1, 0, 1, 1, 0, 31, 0, 36, 1, 10, 1, 32, 1, 12, 1, 1,
            4, 4, 4, 4, 33, 9, 9, 9, 34, 4, 4, 4, 4, 4, 16, 16, 16, 4, 4, 4, 4, 4, 4, 4, 4, 4, 4, 4, 4, 4]
}
